Attempt	Real
lit-er	li-ter
detri-ment	det-ri-ment
es-ta-blish	es-tab-lish
stra-te-g-ic	stra-te-gic
flo-ral	flo-r-al
cou-sin	cous-in
ta-male	ta-ma-le
proa	pro-a
em-a-ci-at-ed	e-ma-ci-at-ed
cymo-phane	cy-mo-phane
pos-y	po-sy
brother-hood	broth-er-hood
for-getting	for-get-ting
kach-i-na	ka-chi-na
is-o-gloss	i-so-gloss
a-bo	ab-o
o-ver-wear-y	o-ver-wea-ry
al-if	a-lif
con-train-di-ca-tion	con-tra-in-di-ca-tion
in-trig-u-er	in-tri-guer
re-dem-pto-ry	re-demp-to-ry
gaited	gait-ed
re-fre-sh-ing	re-fresh-ing
bal-la-dry	bal-lad-ry
can-o-rous-ness	ca-no-rous-ness
un-gul-i-grade	un-gu-li-grade
dime-thyl-benzene	di-meth-yl-ben-zene
i-so	iso
feof-fer	feoff-er
lil-li-pu-tian	lil-li-pu-ti-an
ru-ler	rul-er
stupe-fy	stu-pe-fy
nice-ty	ni-ce-ty
spif-fy	spiff-y
e-pise-mat-ic	ep-i-se-mat-ic
da-ven-port	dav-en-port
stov-er	sto-ver
tas-sie	tass-ie
o-ver-he-at	o-ver-heat
eiseg-e-sis	eis-e-ge-sis
drea-my	dream-y
in-nov-a-tive	in-no-va-tive
sper-ma-to-zoid	sper-ma-to-zo-id
mil-lipede	mil-li-pede
ste-re-oi-som-er-ism	ste-re-o-i-som-er-ism
pro-dro-mal	prod-ro-mal
ye-ti	yet-i
ab-solv-ent	ab-sol-vent
sa-ch-et	sa-chet
a-phot-ic	a-pho-tic
con-cordance	con-cord-ance
a-can-tho-di-an	ac-an-tho-di-an
o-ro-gen-ic	or-o-gen-ic
a-b-id-ing-ly	a-bid-ing-ly
jes-ter	jest-er
a-node	an-ode
bushi-do	bu-shi-do
de-tri-tiv-o-rous	det-ri-tiv-or-ous
ir-re-me-a-ble	ir-rem-e-a-ble
sy-naes-the-si-a	syn-aes-the-si-a
ep-is-teme	ep-i-ste-me
wi-dow	wid-ow
a-nam-ne-sis	an-am-ne-sis
bul-lock-y	bull-ock-y
con-tro-ver-ti-ble	con-tro-vert-i-ble
cate-na	ca-te-na
ad-jec-tive-ly	ad-jec-tively
re-spite	res-pite
in-fer-red	in-ferred
e-lee-mos-y-nar-y	el-e-e-mos-y-nar-y
bi-bli-ot-ic	bib-li-ot-ic
cha-mois	cham-ois
ze-nith	zen-ith
con-ceded	con-ced-ed
e-poch	ep-och
as-tro-phy-sics	as-tro-phys-ics
shel-ly	shell-y
anime	a-nime
mul-tip-li-ca-tion	mul-ti-pli-ca-tion
ion-ize	i-on-ize
i-ch-or	i-chor
t-me-sis	tme-sis
le-gend	leg-end
par-que-try	par-quet-ry
wonted-ly	wont-ed-ly
glos-soph-a-ryn-geal	glos-so-pha-ryn-ge-al
ba-ron	bar-on
mai-den-hood	maid-en-hood
guil-ty	guilt-y
pho-nem-ic	pho-ne-mic
bed-im	be-dim
musk-eg	mus-keg
rep-u-di-ate	re-pu-di-ate
res-igned	re-signed
a-pos-to-lic-i-ty	a-pos-to-lic-ity
pro-tean	pro-te-an
pro-gnos-ti-cate	prog-nos-ti-cate
xe-noge-ny	xe-nog-e-ny
na-nom-e-tre	na-no-me-tre
bec-quer-el	bec-que-rel
host-ler	hos-tler
ac-ces-sor-ize	ac-ces-so-rize
lit-toral	lit-to-ral
spi-r-i-tis-tic	spir-it-is-tic
re-ce-ipt	re-ceipt
car-ne-li-an	car-nel-ian
ion	i-on
pro-vided	pro-vid-ed
ep-i-cri-sis	e-pic-ri-sis
a-me-li-o-rate	a-mel-io-rate
wrap-ped	wrapped
wol-fish	wolf-ish
gases	gas-es
ri-co-chet	ric-o-chet
limes	li-mes
preemp-tive	pre-emp-tive
jam-b	jamb
de-hy-dro-ge-na-tion	de-hy-dro-gen-a-tion
re-cog-nise	rec-og-nise
pla-card	plac-ard
di-ap-er	di-a-per
po-lis	pol-is
ca-m-ouf-lage	cam-ou-flage
he-taer-a	he-tae-ra
bal-boa	bal-bo-a
bak-er	ba-ker
fic-ti-on-al-i-za-tion	fic-tion-al-i-za-tion
fin-als	fi-nals
ti-bi-al	tib-i-al
grande	gran-de
pri-cey	price-y
re-ver-si-ble	re-vers-i-ble
o-lecra-non	o-lec-ra-non
ladi-no	la-di-no
yi-eld-ing	yield-ing
vi-b-ra-to	vi-bra-to
bes-tir	be-stir
ev-er-y-bo-dy	eve-ry-bod-y
jam-be	jambe
ra-pier	ra-pi-er
mar-im-ba	ma-rim-ba
co-lor-ful	col-or-ful
rec-i-pient	re-cip-i-ent
qua-d-ren-ni-um	quad-ren-ni-um
he-donist	he-don-ist
souch-ong	sou-chong
sau-cy	sauc-y
bar	ba-r
tra-ver-tine	trav-er-tine
cle-v-er-ly	clev-er-ly
car-am-ba	ca-ram-ba
clas-sy	class-y
pro-digious	pro-di-gious
phon-o-graph	pho-no-graph
ste-re-oi-som-er-ism	ster-e-o-i-som-er-ism
ma-ke-shift	make-shift
pi-er	pier
ob-stin-a-cy	ob-sti-na-cy
bu-y-a-ble	buy-a-ble
er-a	e-ra
troi-l-ism	troil-ism
hein-ie	hei-nie
o-don-tal-gi-a	o-don-tal-gia
hem-pen	hemp-en
a-dept	ad-ept
no-vice	nov-ice
sal-a-mi	sa-la-mi
ban-do-li-er	ban-do-lier
cat-ter-y	cat-te-ry
pre-sen-ta-tion	pres-en-ta-tion
braided	braid-ed
quar-re-ler	quar-rel-er
beeswing	bees-wing
mus-krat	musk-rat
bar-o-net	bar-on-et
cate-nar-y	cat-e-nar-y
me-dic-in-a-ble	me-dic-i-na-ble
ep-is-co-pa-l-i-an	e-pis-co-pa-li-an
bac-ter-i-o-phage	bac-te-ri-o-phage
ad-voc-a-cy	ad-vo-ca-cy
pat-ri-ot-ic	pa-tri-ot-ic
item	i-tem
au-tark-ic	au-tar-kic
riches	rich-es
til-lage	till-age
mes-siah	mes-si-ah
play-a	pla-ya
wretched	wretch-ed
a-ke-ton	ake-ton
con-fi-gure	con-fig-ure
poly-he-dron	pol-y-he-dron
where-v-er	wher-ev-er
titer	ti-ter
ha-z-ard	haz-ard
un-se-conded	un-sec-ond-ed
pana-che	pa-nache
spir-a-cle	spi-ra-cle
lousy	lous-y
par-mi-gi-a-na	par-mi-gia-na
rem-i-grate	re-mi-grate
ter-rorize	ter-ror-ize
roo-f-er	roof-er
un-stinted	un-stint-ed
drug-g-ing	drug-ging
stapes	sta-pes
fat-a-list	fa-tal-ist
ia-troch-e-mis-try	i-at-ro-chem-is-try
re-sur-rec-tion	res-ur-rec-tion
sax-o-ph-o-nist	sax-o-phon-ist
lob-o-la	lo-bo-la
rhet-o-ri-ci-an	rhe-tor-i-cian
or-gan-i-zer	or-gan-iz-er
in-ha-bit-ed	in-hab-it-ed
pro-fi-ci-en-cy	pro-fi-cien-cy
id-e-a-tion	i-de-a-tion
fal-co-net	fal-con-et
u-ni-on	un-ion
al-phan-u-mer-i-cal-ly	al-pha-nu-mer-i-cal-ly
cum-min-gtonite	cum-ming-ton-ite
a-cyc-lic	a-cy-clic
fil-i-oque	fil-i-o-que
cin-e-re-ous	ci-ner-e-ous
per-cept-i-ble	per-cep-ti-ble
oa-fish	oaf-ish
tran-spon-i-ble	trans-po-ni-ble
is-o-bath-ic	i-so-bath-ic
col-loqui-al-ly	col-lo-qui-al-ly
sy-naere-sis	syn-aer-e-sis
mis-ty	mist-y
de-sue-tude	des-u-e-tude
u-phol-ster-y	up-hol-ster-y
bur-glar-y	bur-gla-ry
com-a-tose	co-ma-tose
di-rig-i-ble	dir-i-gi-ble
pe-r-i-o-date	pe-ri-o-date
paries	par-i-es
made-leine	mad-e-leine
wrong-doing	wrong-do-ing
a-bh-or-rer	ab-hor-rer
che-ri-mo-y-a	cher-i-moy-a
spiri-tous	spir-i-tous
cur-mud-geon	cur-mudg-eon
spruik	spru-ik
bra-dy-ki-nin	brad-y-kin-in
o-ve-r-e-aten	o-ver-eat-en
tro-che	troche
pro-mon-to-ry	prom-on-to-ry
ra-piered	ra-pi-ered
ki-lom-e-ter	kil-o-me-ter
pre-dic-t-a-ble	pre-dict-a-ble
ag-glu-tin-a-tive	ag-glu-ti-na-tive
join-tress	joint-ress
su-per-ce-les-ti-al	su-per-ce-les-tial
polyg-a-mist	po-lyg-a-mist
mal-i-gnan-cy	ma-lig-nan-cy
mos-sy	moss-y
vehe-mence	ve-he-mence
de-n-ied	de-nied
con-a-tus	co-na-tus
rel-u-mine	re-lu-mine
a-fo-re	a-fore
de-ac-ti-vate	de-ac-tiv-ate
vi-r-us	vi-rus
re-din-te-grate	red-in-te-grate
treen	tre-en
tu-a-tar-a	tu-a-ta-ra
switche-roo	switch-er-oo
mi-cro-bial	mi-cro-bi-al
fa-got	fag-ot
som-me-li-er	som-me-lier
e-m-ir	e-mir
fig-ura-tive	fig-ur-a-tive
ti-er	tier
mali-cious	ma-li-cious
spauld-er	spaul-der
coque-try	co-quet-ry
cal-ler	call-er
in-ter	inter
hear-ti-ly	heart-i-ly
bonz-er	bon-zer
rab-bi-nate	rab-bin-ate
bab-i-che	ba-biche
prol-i-f-er-a-tion	pro-lif-er-a-tion
ab-so-l-utism	ab-so-lut-ism
u-n-er-ring	un-err-ing
car-y-a-tid	car-y-at-id
stringy	string-y
e-ly-tron	el-y-tron
tran-sport	trans-port
ester	es-ter
lar-yn-geal	la-ryn-ge-al
bac-te-r-i-um	bac-te-ri-um
re-lish	rel-ish
an-tonym	an-to-nym
tri-bune	trib-une
par-i-ah	pa-ri-ah
schlim-a-zel	schli-ma-zel
boil-er-maker	boil-er-mak-er
dec-iph-er-er	de-ci-pher-er
ha-pless	hap-less
nap-alm	na-palm
ab-o-lish-a-ble	a-bol-ish-a-ble
cre-n-el-late	cren-el-late
guild-er	guil-der
clim-ber	climb-er
herald-ry	her-ald-ry
em-ployee	em-ploy-ee
o-bit-u-ar-y	o-bi-tu-ar-y
am-idst	a-midst
lechay-im	le-cha-yim
ban-krupt-cy	bank-rupt-cy
whisk-y	whis-ky
pro-duct	prod-uct
ab-ste-m-i-ous-ly	ab-ste-mi-ous-ly
do-gleg	dog-leg
a-bi-og-e-net-ic	a-bi-o-ge-net-ic
jip-i-ja-pa	ji-pi-ja-pa
spal-la-tion	spall-a-tion
men-o-rah	me-no-rah
aq-uamar-ine	aq-ua-ma-rine
cal-que	calque
ro-gers	rog-ers
ab-stin-ent-ly	ab-sti-nent-ly
es-cut-cheon	es-cutch-eon
min-is-te-r-i-um	min-is-te-ri-um
plum-bing	plumb-ing
fix-ing	fix-ing
par-en-chy-ma-tous	par-en-chym-a-tous
fil-i-al	fil-ial
prol-o-gue	pro-logue
in-vol-u-cre	in-vo-lu-cre
ton-y	to-ny
cur-ler	curl-er
sal-mon	salm-on
tan-gy	tang-y
ep-is-co-pa-l-i-an	e-pis-co-pa-lian
val-o-rize	val-or-ize
an-throp-o-mor-phize	an-thro-po-mor-phize
do-sage	dos-age
come-di-an	co-me-di-an
dogged-ness	dog-ged-ness
cou-chant	couch-ant
physi-cist	phys-i-cist
alt-hough	al-though
dra-gon	drag-on
vo-tar-y	vo-ta-ry
fun-niest	fun-ni-est
da-mage	dam-age
fidd-ly	fid-dly
za-b-a-glione	za-ba-glio-ne
om-ni-fic	om-nif-ic
an-glic-i-sa-tion	an-gli-ci-sa-tion
pi-et-ism	pi-e-tism
phi-l-ip-pic	phi-lip-pic
pseu-dep-igra-pha	pseud-e-pig-ra-pha
a-che	ache
pewt-er	pew-ter
ni-veous	niv-e-ous
cle-men-tine	clem-en-tine
ce-le-sta	ce-les-ta
ag-ri-bus-i-ness	ag-ri-busi-ness
dim-i-nish	di-min-ish
bo-re-dom	bore-dom
wea-pon	weap-on
us-ur-pa-tion	u-sur-pa-tion
can-o-e-ing	ca-noe-ing
wily	wil-y
ja-de-ite	jade-ite
u-rus-hiol	u-ru-shi-ol
al-ign-ment	a-lign-ment
de-bouchure	de-bou-chure
tre-b-u-chet	treb-u-chet
re-con-cile	rec-on-cile
a-phe-lion	ap-he-li-on
be-loved	be-lov-ed
ar-tio-dac-tyl	ar-ti-o-dac-tyl
ma-gis-tra-cy	mag-is-tra-cy
whe-re-at	where-at
zoe-trope	zo-e-trope
sa-tur-niid	sa-tur-ni-id
o-blique	ob-lique
ae-sthet-ic	aes-thet-ic
vi-b-ra-tive	vi-bra-tive
caout-chouc	caou-tchouc
ver-i-t-a-ble	ver-i-ta-ble
shib-boleth	shib-bo-leth
pro-mis-cui-ty	prom-is-cu-i-ty
cove-nant	cov-e-nant
a-cau-les-cent	ac-au-les-cent
ze-ta	zeta
eon-ism	e-o-nism
tod-ay	to-day
ye-ster-y-e-ar	yes-ter-year
ba-lac-la-va	bal-a-cla-va
fif-tieth	fif-ti-eth
spi-cy	spic-y
for-ces	forc-es
fi-endish	fiend-ish
de-ae-ra-tion	de-aer-a-tion
sin-ger	sing-er
gaiet-y	gai-e-ty
cris-is	cri-sis
pec-car-y	pec-ca-ry
om-i-cron	o-mi-cron
gela-tin	gel-a-tin
mo-rax-el-la	mor-ax-el-la
jink-er	jin-ker
nu-na-tion	nun-a-tion
ra-tite	rat-ite
tap-er	ta-per
bom-b	bomb
dy-nas-ty	dyn-as-ty
ab-sorbed-ly	ab-sorb-ed-ly
pro-fi-ta-bly	prof-it-a-bly
a-cne	ac-ne
e-p-er-gne	e-pergne
withdrew	with-drew
arach-noid	a-rach-noid
prime-val	pri-me-val
hy-per-pla-si-a	hy-per-plas-i-a
sphenoid	sphe-noid
des-troy-er	de-stroy-er
meas-ly	mea-sly
re-gardant	re-gar-dant
clim-a-tol-o-gy	cli-ma-tol-o-gy
hep-ta-go-nal	hep-tag-o-nal
prair-ie	prai-rie
de-mo-net-ize	de-mon-e-tize
vis-i-ta-tion	vis-it-a-tion
ni-ece	niece
a-rak	ar-ak
fealt-y	fe-al-ty
ci-c-a-trise	cic-a-trise
deve-lop-ed	de-vel-oped
reu-ni-on	re-un-ion
tour	tou-r
lar-yn-ges	la-ryn-ges
res-pi-r-a-to-ry	res-pi-ra-to-ry
souven-ir	sou-ve-nir
sil-ique	si-lique
pap-al	pa-pal
scou-r-er	scour-er
trep-ang	tre-pang
sa-tie-ty	sa-ti-e-ty
ele-venses	e-lev-en-ses
po-ly-phon-ic	pol-y-phon-ic
pa-lette	pal-ette
san-c-ti-ty	sanc-ti-ty
ser-vi-cea-ble	ser-vice-a-ble
ap-o-de-ic-tic	ap-o-deic-tic
ma-rave-di	mar-a-ve-di
wolv-es	wolves
han-d-led	han-dled
con-fided	con-fid-ed
bis-ec-tion	bi-sec-tion
monas-ter-y	mon-as-ter-y
la-gan	lag-an
hom-o-type	ho-mo-type
cir-ros-tra-tus	cir-ro-stra-tus
phi-lis-tine	phil-is-tine
a-voc-a-do	av-o-ca-do
mas-sy	mass-y
la-za-ret	laz-a-ret
re-sil-i-ence	re-sil-ience
col-lab-or-a-tive	col-lab-o-ra-tive
paren-the-size	pa-ren-the-size
dys-pla-si-a	dys-pla-sia
loch-i-a	lo-chi-a
e-thyl	eth-yl
bardic	bard-ic
wharv-es	wharves
ban-ger	bang-er
coterie	co-te-rie
sci-en-ti-f-ic	scientif-ic
ap-o-cry-pha	a-poc-ry-pha
coin-ci-den-tal	co-in-ci-den-tal
gavel	gav-el
u-ne-a-si-ness	un-eas-i-ness
chin-quap-in	chin-qua-pin
vin-ous	vi-nous
su-pra-or-bi-tal	su-pra-or-bit-al
co-rol-lar-y	cor-ol-lar-y
sapless	sap-less
squan-d-er	squan-der
pome-gra-nate	pome-gran-ate
e-pen-thet-ic	ep-en-thet-ic
cy-ano-type	cy-an-o-type
syn-thes-i-z-er	syn-the-siz-er
su-zerain-ty	su-ze-rain-ty
vel-a-r-ize	ve-lar-ize
trust-wort-hy	trust-wor-thy
tach-yg-ra-phy	ta-chyg-ra-phy
somite	so-mite
tow-ard-ly	to-ward-ly
max-im-ize	max-i-mize
snows-torm	snow-storm
winn-ing	win-ning
biz-ar-re-ness	bi-zarre-ness
lily	lil-y
tu-ber-ose	tube-rose
priestess	priest-ess
is-o-la-tion-ism	i-so-la-tion-ism
a-pi-ar-ist	a-pi-a-rist
mame-luke	mam-e-luke
beg-gary	beg-gar-y
the-re-at	there-at
a-do-les-cence	ad-o-les-cence
mil-que-toast	milque-toast
un-fort-u-nate	un-for-tu-nate
ool-o-gy	o-ol-o-gy
ave	a-ve
ho-ver-craft	hov-er-craft
co-vet	cov-et
playw-right	play-wright
ar-mis-tice	ar-mi-stice
ushab-ti	u-shab-ti
mouser	mous-er
scen-ic	sce-nic
cha-plain	chap-lain
can-al	ca-nal
ro-sin	ros-in
ban-dage	band-age
chosen	cho-sen
creat-ed	cre-at-ed
non-tri-vi-al	non-triv-i-al
te-o-sinte	te-o-sin-te
my-th-i-cal	myth-i-cal
am-nion	am-ni-on
ge-l-id	gel-id
a-v-id	av-id
reas-sure	re-as-sure
le-ot-ard	le-o-tard
e-stat-ed	es-tat-ed
si-m-o-om	si-moom
fla-ge-o-let	flag-eo-let
beat-i-tude	be-at-i-tude
re-ver-end	rev-er-end
ailu-ro-phil-i-a	ai-lu-ro-phil-i-a
i-r-on-bark	i-ron-bark
blas-ter	blast-er
spo-on-er-ism	spoon-er-ism
gwy-ni-ad	gwyn-i-ad
am-e-nor-rhoe-a	a-men-or-rhoe-a
mul-ti-tu-d-i-nous	mul-ti-tu-di-nous
dum-bly	dumb-ly
pla-net	plan-et
de-fe-ca-tion	def-e-ca-tion
in-cre-dul-i-ty	in-cre-du-li-ty
schle-mi-el	schle-miel
dis-coun-ten-ance	dis-coun-te-nance
post-doc-to-r-al	post-doc-tor-al
kishke	kish-ke
in-trig-u-ing	in-tri-guing
por-ce-lain	porce-lain
el-sewh-ith-er	else-whith-er
ho-oey	hoo-ey
u-plift	up-lift
shand-y	shan-dy
thy-s-elf	thy-self
ra-dii	ra-di-i
gre-gari-ous	gre-gar-i-ous
voc-a-ble	vo-ca-ble
dich-ro-mate	di-chro-mate
mor-ning	morn-ing
am-i-no	a-mi-no
in-fu-ri-ate	in-fur-i-ate
be-d-az-zle	be-daz-zle
cu-ra-tive	cur-a-tive
de-car-bon-i-zer	de-car-bon-iz-er
x-ing	xin-g
fal-ser	fals-er
bor-ne	borne
sur-rend-er	sur-ren-der
de-bri-ef	de-brief
fen-der	fend-er
derv-ish	der-vish
ne-ces-sar-y	nec-es-sar-y
pro-gnos-tic	prog-nos-tic
towkay	tow-kay
re-joind-er	re-join-der
sighted	sight-ed
bi-got	big-ot
ae-ro-stat-ic	aer-o-stat-ic
un-ac-cept-a-ble	un-ac-cep-ta-ble
u-pheld	up-held
weir-do	weird-o
cas-si-a	cas-sia
vo-ter	vot-er
cana-lic-u-lus	can-a-lic-u-lus
salve	sal-ve
he-roine	her-o-ine
a-brupt-ness	ab-rupt-ness
in-her-i-tance	in-her-it-ance
be-s-tride	be-stride
til-bury	til-bur-y
ced-ar	ce-dar
la-men-ta-tions	lam-en-ta-tions
cho-ri-zo	chor-i-zo
sy-no-vi-al	syn-o-vi-al
cat-ar-act	cat-a-ract
nu-die	nud-ie
quiet-ly	qui-et-ly
im-pri-son	im-pris-on
ca-py-ba-ra	cap-y-ba-ra
fretted	fret-ted
bac-te-ri-osta-sis	bac-te-ri-o-sta-sis
pro-phet	proph-et
gos-sam-er-y	gos-sa-mer-y
fa-ci-al	fa-cial
en-tit-le-ment	en-ti-tle-ment
pan-chay-at	pan-cha-yat
e-p-is-tem-ic	ep-is-tem-ic
a-den-i-tis	ad-e-ni-tis
ba-ke-house	bake-house
pro-fit-a-ble	prof-it-a-ble
beheld	be-held
om-nis-ci-ent	om-nis-cient
pe-ri-od-ic	per-i-od-ic
ex-haus-ti-ble	ex-haust-i-ble
fril-ly	frill-y
co-nure	con-ure
ed-i-fi-ca-to-ry	e-dif-i-ca-to-ry
tidd-ly-winks	tid-dly-winks
pla-gi-a-r-y	pla-gia-ry
soiree	soi-ree
pala-ver	pa-la-ver
chok-es	chokes
slavish-ly	slav-ish-ly
an-nui-ty	an-nu-i-ty
proph-e-s-y	proph-e-sy
con-ven-ti-o-nal-i-ty	con-ven-tion-al-i-ty
doub-loon	dou-bloon
hy-dro-pho-bi-a	hy-dro-pho-bia
humm-ing	hum-ming
flor-u-it	flo-ru-it
su-brep-tion	sub-rep-tion
eph-e-drine	e-phed-rine
doeth	do-eth
an-ti-po-des	an-tip-o-des
re-veille	rev-eil-le
phas-ic	pha-sic
pap-er	pa-per
pan-to-fle	pan-tof-le
so-met-i-mes	some-times
twel-ve-month	twelve-month
car-a-bao	ca-ra-ba-o
fom-ites	fom-i-tes
wonted	wont-ed
vil-la	vi-lla
merk-in	mer-kin
ir-re-frang-i-ble	ir-re-fran-gi-ble
e-lec-to-ral	e-lec-tor-al
pony	po-ny
per-pe-tui-ty	per-pe-tu-i-ty
ki-el-ba-sa	kiel-ba-sa
as-trad-dle	a-strad-dle
bunker	bun-ker
clin-o-graph	cli-no-graph
bota-ny	bot-a-ny
a-be-ce-da-ri-a	a-be-ce-dar-i-a
whitey	whit-ey
deve-lop	de-vel-op
so-rites	so-ri-tes
pal-my	palm-y
per-nick-e-ty	per-nick-et-y
hov-en	ho-ven
du-r-ing	dur-ing
ex-i-gui-ty	ex-i-gu-i-ty
bar-my	barm-y
mar-i-a-chi	mar-i-ach-i
goo-gly	goog-ly
de-fa-cer	de-fac-er
man-ip-u-la-tive	ma-nip-u-la-tive
co-di-c-il	cod-i-cil
go-ver-nor	gov-er-nor
mea-sure-ment	meas-ure-ment
geos-phere	ge-o-sphere
the-o-do-lite	the-od-o-lite
spi-r-al	spi-ral
haec-cei-ty	haec-ce-i-ty
ene-my	en-e-my
ac-cid-ie	ac-ci-die
dos-ser	doss-er
co-lum-nist	col-umn-ist
cud-gel	cudg-el
og-doad	og-do-ad
but-tin-ski	butt-in-ski
ac-at-a-lec-tic	a-cat-a-lec-tic
sar-ru-so-phone	sar-rus-o-phone
man-i-la	ma-nil-a
tran-shu-mance	trans-hu-mance
ben-ign	be-nign
flo-wer-pot	flow-er-pot
par-a-cet-a-mol	pa-ra-ce-ta-mol
misuse	mis-use
lore	lo-re
at-ri-al	a-tri-al
in-solv-ent	in-sol-vent
oc-u-lo-m-o-tor	oc-u-lo-mo-tor
cloth-ier	clo-thi-er
pro-v-i-den-tial	prov-i-den-tial
de-car-box-y-lase	de-car-box-yl-ase
de-serv-ed	de-served
toas-tiness	toast-i-ness
rob-o-rant	ro-bor-ant
righ-to	right-o
pla-code	plac-ode
frac-ti-on-i-za-tion	frac-tion-i-za-tion
am-phith-e-a-tre	am-phi-the-a-tre
un-plea-sant	un-pleas-ant
hep-tas-tyle	hep-ta-style
ac-com-pan-i-ment	ac-com-pa-ni-ment
res-cru-ti-ny	re-scru-ti-ny
ar-ti-sa-nal	ar-ti-san-al
bi-nar-y	bi-na-ry
ben-i-gnant	be-nig-nant
noc-i-cep-tive	no-ci-cep-tive
u-nu-su-al	un-u-su-al
ti-a-r-a	ti-ar-a
conur-ba-tion	con-ur-ba-tion
di-ple-gi-a	di-ple-gia
ban-ded	band-ed
a-sym-ptot-ic	as-ymp-tot-ic
mil-lin-er-y	mil-li-ner-y
con-sultant	con-sult-ant
div-in-a-to-ry	di-vin-a-to-ry
co-d-a	co-da
ob-nox-i-ous-ly	ob-nox-ious-ly
ail-u-ro-phobe	ai-lu-ro-phobe
prospec-tor	pro-spec-tor
pre-sen-ta-tive	pre-sent-a-tive
taj	taj
ar-te-si-an	ar-te-sian
met-a-mor-pho-sis	met-amor-phosis
cy-tog-e-net-ic	cy-to-ge-net-ic
blith-e-ful	blithe-ful
ba-lance	bal-ance
voc-a-l-ist	vo-cal-ist
re-for-ma-tion	ref-or-ma-tion
twenty	twen-ty
pro-por-tio-nal-i-ty	pro-por-tion-al-i-ty
quas-ar	qua-sar
ou-tride	out-ride
pro-gramm-ing	pro-gram-ming
duster	dust-er
dis-tur-bance	dis-turb-ance
mo-ral-ize	mor-al-ize
per-fu-mer	per-fum-er
fath-er-ly	fa-ther-ly
che-mist	chem-ist
per-func-to-r-i-ly	per-func-to-ri-ly
ro-tar-y	ro-ta-ry
in-cle-ment	in-clem-ent
de-mo-ral-is-ing	de-mor-al-is-ing
whist-ler	whis-tler
re-veille	re-veil-le
tele-mark	tel-e-mark
cal	ca-l
goph-er	go-pher
cru-de-ly	crude-ly
em-it-ter	e-mit-ter
ce-re-ous	cer-e-ous
res-cind	re-scind
ac-ti-vist	ac-tiv-ist
e-o-si-no-phil	e-o-sin-o-phil
cin-que-foil	cinque-foil
crinet	crin-et
sa-tin	sat-in
a-bys-sal	a-byss-al
at-o-mist	at-om-ist
pag-o-da	pa-go-da
erlking	erl-king
forda-ble	ford-a-ble
cla-vi-er	clav-ier
usage	us-age
u-n-ex-pect-ed	un-ex-pec-ted
graces	grac-es
vul-ca-nol-o-gist	vul-can-ol-o-gist
a-vi-a-r-y	a-vi-ar-y
ec-dy-si-ast	ec-dys-i-ast
fi-chu	fich-u
a-can-thop-te-ry-gi-an	ac-an-thop-ter-yg-i-an
meg-ilp	me-gilp
un-re-a-son-a-bly	un-rea-son-a-bly
re-mo-val	re-mov-al
laic	la-ic
chand-ler	chan-dler
a-da-gio	a-da-gi-o
func-ti-on-al-ist	func-tion-al-ist
pros-cribe	pro-scribe
tri-bute	trib-ute
doing	do-ing
he-re-to	here-to
prole-tar-i-an-i-za-tion	pro-le-tar-i-an-i-za-tion
bil-i-r-u-bin	bil-i-ru-bin
caes-u-ra	cae-su-ra
dis-par-ate	dis-pa-rate
tom-o-rrow	to-mor-row
smelling	smell-ing
fo-re-paw	fore-paw
phy-si-ol-o-gy	phys-i-ol-o-gy
po-ly	pol-y
ba-r-i	ba-ri
cla-mor	clam-or
bi-er	bier
ce-d-i	ce-di
di-a-mond	dia-mond
post-pran-di-al-ly	postpran-di-al-ly
gla-ci-al	gla-cial
pa-reve	pa-re-ve
poet-i-cal	po-et-i-cal
hor-i-zon	ho-ri-zon
joseph	jo-seph
oos-phere	o-o-sphere
dis-am-bi-gu-ate	dis-am-big-u-ate
creole	cre-ole
pap-ist	pa-pist
ex-per-tize	ex-pert-ize
whe-re-un-to	where-un-to
ep-ig-ra-phy	e-pig-ra-phy
sep-tu-age-nar-y	sep-tu-ag-e-nar-y
a-pose-mat-ic	ap-o-se-mat-ic
steeple-less	stee-ple-less
gut-tat-im	gut-ta-tim
lat-reut-ic	la-treu-tic
gal-vanize	gal-va-nize
coo-ties	coot-ies
qui-e-tis-tic	qui-et-is-tic
slend-er	slen-der
bloom-er	bloo-mer
dy-nam-o-gen-ic	dy-na-mo-gen-ic
con-spec-i-f-ic	con-spe-cif-ic
un-ble-mish-a-ble	un-blem-ish-a-ble
dei-ty	de-i-ty
ne-crop-o-lises	ne-crop-o-lis-es
raz-or	ra-zor
core	co-re
lap-el	la-pel
fas-cic-u-lus	fas-ci-cu-lus
hy-pon-a-tre-mi-a	hy-po-na-tre-mi-a
je-wel-ler-y	jew-el-ler-y
mis-joind-er	mis-join-der
su-per-heter-o-dyne	su-per-het-er-o-dyne
dag-u-er-re-o-type	da-guerre-o-type
pres-ci-ence	pre-sci-ence
de-mos	dem-os
chir-py	chirp-y
seign-i-o-ry	sei-gnior-y
re-con-noitre	re-con-noi-tre
my-al-g-ic	my-al-gic
a-de-no-sine	a-den-o-sine
pa-ja-mas	pa-jam-as
pen-ta-g-o-nal	pen-tag-o-nal
ep-i-lo-gue	ep-i-logue
ar-ith-me-ti-ci-an	a-rith-me-ti-cian
bime-tal-lic	bi-me-tal-lic
a-me-li-o-ra-tion	a-me-lio-ra-tion
ap-ar-theid	a-part-heid
o-ver-seer	o-ver-se-er
wizened	wiz-ened
befo-retime	be-fore-time
o-th-er	oth-er
lime-y	lim-ey
de-ter-i-o-ra-tion	de-te-ri-o-ra-tion
ne-go-ti-a-ble	ne-go-tia-ble
trov-er	tro-ver
mo-ray	mor-ay
cre-ol-ize	cre-o-lize
prose-lytize	pros-e-lyt-ize
sump-tu-ar-y	sump-tu-a-ry
ga-som-e-ter	gas-om-e-ter
par-al-lel-e-pip-ed	par-al-lel-e-pi-ped
unite	u-nite
god-fath-er	god-fa-ther
mer-in-gue	me-ringue
county	coun-ty
ev-i-t-a-ble	ev-i-ta-ble
hom-o-gen-e-sis	ho-mo-gen-e-sis
nor-thern-most	north-ern-most
sy-noe-cious	syn-oe-cious
jag-u-ar	jag-uar
bak-la-va	ba-kla-va
al-i-e-nate	al-ien-ate
cox-com-bry	cox-comb-ry
de-bugg-ing	de-bug-ging
sor-tilege	sor-ti-lege
pro-fi-ci-ent	pro-fi-cient
straigh-ta-way	straight-a-way
hard-ened	har-dened
nop-al	no-pal
can-ned	canned
boc-ci-a	boc-cia
rhod-ic	rho-dic
a-zide	az-ide
e-pen-dy-ma	ep-en-dy-ma
per-sev-er-ance	per-se-ver-ance
non-pluss-ed	non-plussed
far-mer	farm-er
pea-r-y	pea-ry
feas-i-ble	fea-si-ble
lam-in-gton	lam-ing-ton
re-tros-pec-tive	ret-ro-spec-tive
phy-ton-a-di-one	phy-to-na-di-one
hard-en	har-den
fun-nier	fun-ni-er
por-thole	port-hole
ma-ter-i-a-lism	ma-te-ri-al-ism
or-thoep-y	or-tho-e-py
li-ber-tar-i-an	lib-er-tar-i-an
thy-ro-a-ryte-noid	thy-ro-ar-y-te-noid
eu-hem-er-ism	eu-he-mer-ism
fe-der-a-list	fed-eralist
ca-se-in	ca-sein
ben-ch-er	bench-er
mo-bo-cra-cy	mob-oc-ra-cy
de-cres-cen-do	de-cre-scen-do
birdie	bird-ie
gorhen	gor-hen
ty-pe-script	type-script
un-doing	un-do-ing
do-ter	dot-er
pan-et-tone	pan-et-to-ne
ae-ro-plane	aer-o-plane
ex-cer-ption	ex-cerp-tion
a-bhor	ab-hor
na-g-or	na-gor
u-n-i-lat-er-al	u-ni-lat-er-al
vic-e-roy-al-ty	vice-roy-al-ty
bis-ho-pric	bish-op-ric
brute	bru-te
me-no-pause	men-o-pause
syn-thes-ize	syn-the-size
su-blux-a-tion	sub-lux-a-tion
mem-branous	mem-bra-nous
clean-liness	clean-li-ness
li-ber-ty	lib-er-ty
the-re-a-bout	there-a-bout
at-ri-ch-o-sis	at-ri-cho-sis
bu-ry	bur-y
gru-ni-on	grun-ion
rhot-ic	rho-tic
cul-tist	cult-ist
u-ro-py-gi-al	u-ro-pyg-i-al
re-gis-trar	reg-is-trar
pap-er-hang-er	pa-per-hang-er
lan-drace	land-race
mil-liard	mil-li-ard
bounty	boun-ty
uphe-a-val	up-heav-al
tran-spose	trans-pose
cri-te-r-i-on	cri-te-ri-on
soph-ro-syne	so-phros-y-ne
af-gha-ni	af-ghan-i
cor-por-a-tive	cor-po-ra-tive
chif-fon-ade	chif-fo-nade
spark-le	spar-kle
ea-s-y	eas-y
naive	na-ive
goer	go-er
go-vern	gov-ern
zai-bat-su	zai-ba-tsu
cau-sal	caus-al
going	go-ing
ragged	rag-ged
ev-er-y-th-ing	eve-ry-thing
fours-quare	four-square
de-con-ge-stant	de-con-ges-tant
a-zote	az-ote
feof-fee	feoff-ee
che-von	chev-on
cly-peus	clyp-e-us
colo-red	col-or-ed
wedgie	wedg-ie
hy-dran-ge-a	hy-dran-gea
tet-ch-y	tetch-y
te-net	ten-et
whoev-er	who-ev-er
stiv-er	sti-ver
fi-ance	fi-an-ce
hi-ma-lay-as	him-a-la-yas
leis	le-is
slu-gabed	slug-a-bed
in-troit	in-tro-it
coa-li-tion	co-a-li-tion
pa-ja-ma	pa-jam-a
pan-ur-gic	pan-urg-ic
chile	chil-e
dac-ty-lo-gram	dac-tyl-o-gram
pa-late	pal-ate
ay-in	a-yin
as-cen-dance	as-cend-ance
de-du-c-i-bly	de-duc-i-bly
lum-bric-a-lis	lum-bri-ca-lis
func-ti-on-al-ism	func-tion-al-ism
shunn-ing	shun-ning
om-niv-o-rous	om-niv-or-ous
eq-ui-vo-ca-tion	e-quiv-o-ca-tion
pe-tron-el	pet-ro-nel
hoyd-en	hoy-den
hoov-er	hoo-ver
du-bit-a-ble	du-bi-ta-ble
broad-cas-ter	broad-cast-er
vale	va-le
troch-lea	troch-le-a
car-afe	ca-rafe
fas-cial	fas-ci-al
pred-i-lec-tion	pre-di-lec-tion
pas-sport	pass-port
fain-e-ant	fai-ne-ant
gu-ar-di-an	guard-i-an
rem-i-gra-tion	re-mi-gra-tion
im-par-i-syl-lab-ic	im-par-i-syl-la-bic
de-sic-ca-tion	des-ic-ca-tion
e-pen-the-sis	ep-en-the-sis
pan-ni-er	pan-nier
ey-e-hook	eye-hook
lam	la-m
ca-r-ol	car-ol
said	sa-id
conse-quent-ly	con-se-quent-ly
with-dra-wal	with-draw-al
war-drobe	ward-robe
ab-son-ant	ab-so-nant
am-or-ti-za-tion	a-mor-ti-za-tion
de-fla-gra-tion	def-la-gra-tion
tin-i-ness	ti-ni-ness
dand-y	dan-dy
judger	judg-er
plo-tless-ness	plot-less-ness
cris-per	crisp-er
az-u-rite	az-ur-ite
de-coup-ling	de-cou-pling
per-ferv-id	per-fer-vid
teas-poon	tea-spoon
deathbed	death-bed
sy-non-y-mous	syn-on-y-mous
mue-s-li	mues-li
ge-ostro-ph-ic	ge-o-stroph-ic
guided	guid-ed
pin-ko	pink-o
de-mon-strat-ed	dem-on-strat-ed
dis-pen-ser	dis-pens-er
sel-d-om	sel-dom
pic-tu-ri-za-tion	pic-tur-i-za-tion
o-ven	ov-en
tric-y-cle	tri-cy-cle
ai	a-i
u-pend	up-end
in-tel-lig-i-bil-i-ty	in-tel-li-gi-bil-i-ty
di-s-an-nul	dis-an-nul
no-ra-dren-a-line	nor-a-dren-a-line
iw-is	i-wis
hy-oid-e-an	hy-oi-de-an
wear-ied	wea-ried
wain-s-cot-ting	wain-scot-ting
heb-do-ma-dal	heb-dom-a-dal
hi-ero-glyph	hi-er-o-glyph
a-dhe-sive	ad-he-sive
draugh-ty	draught-y
dithe-ist	di-the-ist
po-ly-tonal	pol-y-ton-al
valk-y-rie	val-kyr-ie
spen-der	spend-er
slu-ice	sluice
tran-scon-ti-nen-tal	trans-con-ti-nen-tal
moles-ter	mo-lest-er
locks-mith-ing	lock-smith-ing
brach-i-ate	bra-chi-ate
o-per-at-a-ble	op-er-at-a-ble
a-c-u-mi-na-tion	a-cu-mi-na-tion
hoo-pla	hoop-la
com-mitted	com-mit-ted
pa-ro-no-ma-si-a	par-o-no-ma-sia
eq-ui-nox	e-qui-nox
ki-lo-gram	kil-o-gram
bridges	bridg-es
misled	mis-led
pol-y-cy-them-ic	pol-y-cy-the-mic
me-teor	me-te-or
ep-i-ph-a-ny	e-piph-a-ny
cor-dage	cord-age
routed	rout-ed
war-mer	warm-er
o-don-tal-gi-a	od-on-tal-gi-a
grainy	grain-y
trans-mitted	trans-mit-ted
hy-pote-nuse	hy-pot-e-nuse
her-mi-tage	her-mit-age
o-beah	o-be-ah
cave	ca-ve
pen-thouse	pent-house
dys-to-pi-a	dys-top-i-a
tele-g-ra-phy	te-leg-ra-phy
rap-proch-e-ment	rap-proche-ment
per-jury	per-jur-y
mul-tip-li-cand	mul-ti-pli-cand
withal	with-al
stev-en	ste-ven
coun-ta-ble	count-a-ble
re-a-son-ing	rea-son-ing
hand-ler	han-dler
la-fay-ette	la-fa-yette
dhy-a-na	dhya-na
a-bre-act	ab-re-act
pla-teau	plat-eau
ki-lo	kil-o
coro-nis	co-ro-nis
se-wage	sew-age
pat-roon-ship	pa-troon-ship
ti-t-ra-tion	ti-tra-tion
co-lo	colo
pres-u-ma-bly	pre-sum-a-bly
of-fi-ciant	of-fi-ci-ant
ad-mitted	ad-mit-ted
ep-ith-a-la-mi-um	ep-i-tha-la-mi-um
u-n-i-ver-sal-ly	u-ni-ver-sal-ly
prov-id-ing	pro-vid-ing
dis-tri-b-u-tive	dis-trib-u-tive
gar-re-teer	gar-ret-eer
gla-cis	glac-is
a-mor-tize	am-or-tize
lo-d-en	lo-den
lim-e-r-ick	lim-er-ick
li-kel-i-hood	like-li-hood
car-ci-nom-a-ta	car-ci-no-ma-ta
con-su-mer	con-sum-er
sty-list	styl-ist
mark-ed	marked
twee-n-y	tween-y
of-fi-ci-al-dom	of-fi-cial-dom
ec-u-men-ic	e-cu-men-ic
beek-eep-er	bee-keep-er
mo-no-ki-ni	mon-o-ki-ni
sin-e-cure	si-ne-cure
prota-mine	pro-ta-mine
pro-tease	pro-te-ase
charac-ter-y	char-ac-ter-y
gut-tu-ral	gut-tur-al
on-cer	onc-er
dul-lard	dull-ard
o-verse-vere	o-ver-se-vere
so-pra-no	so-pran-o
im-pe-n-et-ra-ble	im-pen-e-tra-ble
glo-bal-ly	glob-al-ly
wom-a-nish	wom-an-ish
man	ma-n
mon-ar-chic	mo-nar-chic
am-e-nor-rhoe-ic	a-men-or-rhoe-ic
san-ies	sa-ni-es
brain-s-torm	brain-storm
gal-a-go	ga-la-go
esthe-sis	es-the-sis
dis-ar-ma-ment	dis-arm-a-ment
chit-in	chi-tin
wav-y	wa-vy
fo-re-ign-ness	for-eign-ness
ab-id-ing	a-bid-ing
whore-mon-ger	whore-mong-er
bee-fy	beef-y
tat-ter-de-ma-lion	tat-ter-de-mal-ion
de-ca-dal	dec-a-dal
di-a-t-o-mite	di-at-o-mite
ig-nor-a-mus	ig-no-ra-mus
sye-nite	sy-e-nite
tag-li-a-tel-le	ta-glia-tel-le
nad-ir	na-dir
as-tride	a-stride
ec-o-tone	e-co-tone
ko-ni-a	kon-ia
gus-ty	gust-y
thi-ou-re-a	thi-o-u-re-a
pro-ven-der	prov-en-der
vol-tage	volt-age
tum-blew-eed	tum-ble-weed
sy-co-phant	syc-o-phant
powd-ers	pow-ders
hel-lish	hell-ish
pe-t-i-tion	pe-ti-tion
gu-ai-a-cum	guai-a-cum
le-gate	leg-ate
unk-not	un-knot
e-ryth-e-ma	er-y-the-ma
soi-lage	soil-age
vel-leity	vel-le-i-ty
cu-e-sta	cues-ta
bras-s-y	brass-y
wis-e-a-cre	wise-a-cre
creance	cre-ance
tran-sit	trans-it
pag-a-nist	pa-gan-ist
bin-der	bind-er
dis-har-mon-ize	dis-har-mo-nize
grinning	grin-ning
fu-tu-r-i-ty	fu-tur-i-ty
kam-i-kaze	ka-mi-ka-ze
py-ruvic	py-ru-vic
fil-thy	filth-y
as-sig-na-ble	as-sign-a-ble
gra-zi-er	gra-zier
spireme	spi-reme
wootz	wootz
proo-fread	proof-read
col-ly-ri-um	col-lyr-i-um
pat-chou-li	patch-ou-li
cha-mae-phyte	cham-ae-phyte
prom-pt-ly	prompt-ly
be-l-it-tle	be-lit-tle
Words with errors: 1207
Total evluated: 5000
